wwwwwwwwwwwww
w.h.......hxw
w...........w
w...........w
w....h......w
w...........w
w.........h.w
wA..........w
wwwwwwwwwwwww