wwwwwwwwwwwww
w..........xw
w...........w
w...........w
w...........w
w...........w
w...........w
wA..........w
wwwwwwwwwwwww